111111111111111111111111111111111111111111111111111111111111
1S0110001111111011101001101110000101100010111111101111000101
110001000111110010101111110110111100111010010011011100111001
110010101111000110011100111101110110011111111101001101101101
100001100011101111110101100000111111010110010110110111010111
110000110111010110110110011100011000001010011111001011001111
110010111100101111000011100101000001010000101001011011110011
100010101011101011110101000110110011111110000111111011110011
101000001111101101011010011101110100010000101001110010111111
100000001111010001110001010111110111101111011111101001111011
100000000101100100100111001010010001001111100100001001011101
110000000110110100110101000101101111101011111101110011111111
111010000011111010110111101000111100100001101111111100100001
100110000110111000111111110010001101001101111001010011110111
100111100011010100111110011010110011101001010101110111111111
110110100010001111001110101101000001100011000011001001011111
110110010000000000111011011111101001100101010010000000001111
101101110100100000001000000101110010011101011001110111011001
101011111011100101000010100110111101101101011110110111101011
101110100110111010110010110110100000111111110110101100111111
110000001110110101000000100110111011101011110011110010111011
111010111111111101100001011001101111000010111111111110100011
111000101001010000110000111101000111001001111101011111111111
111001101000011110010000000000101111101111010001101110001111
101110111010100111100000001100101011011111110110000110010111
111010111111011011110000001011101110011010000111010100010111
111101011011001110001011000010011101010110101001010001001101
111100010111011011111101000010110011110000001111011101011001
110010010100010101111101000101111110100001011010010101010011
111111010000111111111101010010111110101111001101000111111101
110010101001111111101101000001010100100011000101100010101111
110100001111011101100000111001110110011010000110111111001011
110101101011010011010011100010100110000111010110011111110011
101000110111111001010011111001101011100111101100110111111111
111111101111100100111100100000001010010010111101111011011101
101010011111010111011100100011011100001100001111010100010111
111000101100010011010100100001010111111101001111110111110101
101000110101010110000101011000011111110100001111101111101001
100011111111010111100111001101010011110101010010110100101101
111010010001100011111111111001111111000111111111111101111011
100110001101100101111011111010000000011010001011100101010101
101010010011111111101111110000101111011010001011110111011011
111010011011110101011000010111100111110000111111111001101011
111011111001110010101010010110100101100111111111011000100001
101010000111110011101011000101110001011111011011011010101011
101101110100111101000111101101001001101001100110110111110001
100011101100111110001011000011111000110110111101100010001111
110100100101001101001011011111111100000001110010011101111011
100011101111110111010011111000100011111000001010111011101111
100011110111111011111000101111101011101100100101001101101101
101111101101111010111111110100000111011110001010001010010101
101001100010011100111111110110001110000010100010000100001111
110100010010001101010101000111111110001111100001011011101011
110110101111000111110111100111110111011101111101001110110011
110101100100001010001101000100111111000111110000111111101111
100101100010111010101011011000001111100110011000000001110111
110001111000011100100011010011111001110010011100010001000001
100000111101101100010001111001011101011101010101011001110011
1100101011010101001011111101001011111011011001011000000000G1
111111111111111111111111111111111111111111111111111111111111